Jayaae
Jayaee	Jayaei
Jayaes	Jayaex	Jayaey	Jayace
Jayace
Jayacy	Jayahe
Jayahi	Jayahr	Jayahs
Jayahx	Jayahy	Jayaie
Jayair	Jayais	Jayaiu	Jayaix
Jayars	Jayarx	Jayary
Jayase	Jayash	Jayasi
Jayass	Jayasx	Jayasy
Jayaxe
Jayaxi	Jayaxs
Jayeae
Jayeas	Jayeax
Jayeea	Jayeee	Jayeeh	Jayeei	Jayeek
Jayees	Jayeex
Jayece	Jayecc	Jayech	Jayeci
Jayecs	Jayecx	Jayecy	Jayehe
Jayehi	Jayehs
Jayehx	Jayehy	Jayeie	Jayeic
Jayeii	Jayeir	Jayeis	Jayeiu
Jayeix	Jayeiy
Jayeks	Jayekx
Jayeox	Jayeoy
Jayers	Jayerx	Jayery
Jayese	Jayesh	Jayesi
Jayess	Jayesx	Jayesy
Jayexh	Jayexi	Jayexs
Jayeye
Jayeys
Jaycee  Jaycei
Jayces  Jaycex	Jaycey
Jaycce	Jaycci
Jayccs  Jayccx	Jayccy
Jaychs	Jaychx	Jaychy	Jaycia	Jaycie
Jaycic	Jaycii	Jaycis
Jaycix	Jayciy
Jaycsi
Jaycss  Jaycsx	Jaycsy
Jaycye
Jaycys
Jayies	Jayiex
Jayice
Jayicy
Jayiie
Jayiis	Jayiix
Jayise	Jayish
Jayisi	Jayiss	Jayisx
Jayoee
Jayoes
Jayoex
Jayohx
Jayohy  Jayoii
Jayois	Jayoiu	Jayoix	Jayoiy

Jaysae
Jaysay
Jaysea	Jaysee	Jaysec	Jayseh	Jaysei
Jayses	Jaysex	Jaysey
Jaysci
Jayscx	Jayscy	Jayshe
Jayshh	Jayshi	Jayshr	Jayshs
Jayshx	Jayshy	Jaysia	Jaysie
Jaysih	Jaysii
Jaysix	Jaysiy
Jaysse	Jayssh	Jayssi
Jaysss	ayssx	Jayssy
Jaysxe
Jaysxs
Jaysxy	Jaysye
Jaysyh	Jaysyi



